2 13 31
###############################
#p b     *          *        b#
#  # #*# # # #  # # # #*#*#####
#  # *     ###**###    * #    #
# #   #    #f  1 b#   *   #   #
# #   #    #      #    * #    #
#  # *     *  ##  *     #    x#
#  # *   1 #      #    * #    #
# #   #    #f    s#   *   #   #
# #   #    ###**###    * #    #
#**# # # #*# #  # #*# #*# #*# #
#         *  *  *  *      ** b#
###############################