1 13 31
###############################
#p b     *   1   2  *        b#
#  # #*# # # #  # # # #*#*#####
#  # *   1 ###**###    * #    #
# #   #    #f  1 b#   *   #   #
# #   # 1  #      #    * #    #
#  # *     *1 ## 1*    1#    x#
#  # *   1 #      #    * #    #
# #   #    #f  1 s#   * 2 #   #
# #   #    ###**###    * #    #
#**# # # #*# #  # #*# #*# #*# #
#2     1  *  *  *  *      ** b#
###############################